#########################
#.......................#
#.#####################.#
#.#...................#.#
#......#.........#......#
#.#....#.........#....#.#
#.######.........######.#
#......#.........#......#
#.#...................#.#
#.#####################.#
#...........S...........#
#########################