#########################
#.............e.........#
#.#####################.#
#.#...................#.#
#...e..#......e..#......#
#.#....#e........#....#.#
#.######.........######.#
#......#.S.......#.e....#
#.#..e........e.......#.#
#.#####################.#
#......e.........e......#
#########################