1111111111111111111111111
1444444444444444444444441
1411111111111111111111141
1414444444444444444444141
1444444144444444414444441
1414444144433344414444141
1411111144444444411111141
1444444144444444414444441
1414444444444444444444141
1411111111111111111111141
1444444444442444444444441
1111111111111111111111111