1111111111111111111111111
1                       1
1 111111111111111111111 1
1 1                   1 1
1      1         1      1
1 1    1   333   1    1 1
1 111111         111111 1
1      1         1      1
1 1                   1 1
1 111111111111111111111 1
1           2           1
1111111111111111111111111